word	meaning	example	example_ja
abandon	leave	He tried to abandon his diet, but the scale kept judging him.	彼はダイエットをやめようとしたけど、体重計がずっと責めてきた。
abate	go down	The storm finally abated... just as his umbrella gave up.	嵐がやっと弱まった……ちょうど傘が壊れたタイミングで。
abbey	church	The ghosts in the abbey insisted on holding choir practice.	修道院の幽霊たちは合唱練習をやめなかった。
abbreviate	shorten	Why say "refrigerator" when you can abbreviate it to "fridge"?	「冷蔵庫」って言うより「フリッジ」って略した方が早いやん。
abdomen	stomach	He blamed his huge abdomen on "air retention," not snacks.	彼はでっぷりしたお腹を「空気のせい」にしてた。お菓子じゃなくて。
abide	follow	He can’t abide by the rules if the rules say no dessert.	ルールがデザート禁止なら、彼はルールに従えない。
abrupt	sudden	The meeting ended so abrupt, even the coffee looked confused.	会議が突然終わりすぎて、コーヒーすら戸惑ってた。
absorb	take in	This sponge absorbs everything... including office gossip.	このスポンジは何でも吸い取る。社内の噂話も含めて。
abstract	unclear	I tried to understand the abstract painting, but it stared back.	抽象画を理解しようとしたら、逆にこっちを見返してきた。
abundant	plenty	There was an abundant supply of snacks… until Dave showed up.	お菓子は山ほどあった……デイブが来るまでは。
abuse	hurt	He abused the coffee machine so much, it started spitting foam.	彼がコーヒーマシンを乱暴に使いすぎて、泡を吹き始めた。
accelerate	go faster	The project started to accelerate once caffeine was introduced.	カフェインが導入されてから、プロジェクトが急加速した。
acceptance	approval	Her cat finally showed acceptance—by not scratching him.	彼女の猫がやっと受け入れてくれた。引っかかなかったから。
access	entry	He forgot his password, so access to his own fridge was denied.	パスワードを忘れて、自分の冷蔵庫にすらアクセスできなかった。
accessible	open	The mountain hut is only accessible by foot.	その山小屋には歩いてしか行けない。
accidental	unplanned	She made an accidental call to her ex at 2AM.	彼女は元カレにうっかり深夜2時に電話してしまった。
accommodate	help	The hotel can accommodate up to 500 guests.	そのホテルは500人まで泊まれる。
accompany	go with	My cat likes to accompany me to the bathroom.	うちの猫はトイレまでついてくるのが好き。
accomplish	finish	He managed to accomplish his goal before lunch.	彼は昼までに目標をやり切った。
accord	match	His story doesn’t accord with the evidence.	彼の話は証拠と合っていない。
accordance	agreement	She acted in accordance with the instructions.	彼女は指示通りに行動した。
according to ~	based on	According to my cat, 5AM is breakfast time.	うちの猫によると朝5時が朝ごはんの時間らしい。
account	explanation	He gave a dramatic account of how he survived.	彼はどう生き延びたかをドラマチックに語った。
accountant	money person	My accountant said “no” with a smile.	会計士は笑顔で「ダメです」と言った。
account for ~	explain	I can’t account for why my fridge is empty again.	また冷蔵庫が空なのを説明できない。
accrue	collect	Points accrue every time you ignore adulting.	大人っぽいことを無視するたびにポイントがたまる。
accurately	exactly	He can accurately guess your mood from your snack choice.	彼はお菓子の選び方で君の気分を当てられる。
accuse	blame	She accused the cake of being too delicious.	彼女はそのケーキが美味しすぎると責めた。
accuse A of ~	say A did ~	They accused the hamster of tax fraud.	彼らはハムスターを脱税で訴えた。
accustom	get used to	I’m slowly accustoming myself to waking up before noon.	昼前に起きるのにちょっとずつ慣れてきた。
ache	pain	My legs ache like I fought a bear in my sleep.	足が痛くて、寝てる間にクマと戦ったみたい。
acid	sour	The lemonade was so acid it woke me up better than coffee.	レモネードが酸っぱすぎてコーヒーより目が覚めた。
acknowledge	accept	He finally acknowledged that the cat was the boss.	ついに彼は猫がボスだと認めた。
acoustic	sound	She bought an acoustic guitar to look more poetic.	彼女は詩人っぽく見せるためにアコギを買った。
acquire	get	I’m trying to acquire the skill of waking up like a human.	人間らしく起きるスキルを身につけようとしてる。
acquisition	getting	The acquisition of snacks was his top priority.	お菓子の確保が彼の最優先事項だった。
acquisitive	greedy	Her acquisitive nature turned her closet into a black hole.	彼女の物欲でクローゼットがブラックホール化した。
activate	start	Pushing this button will activate chaos mode.	このボタンを押すとカオスモードが起動します。
act on ~	do something about ~	He decided to act on his dream of owning a duck army.	彼はアヒル軍団を持つ夢に向かって行動することにした。
actual	real	My actual weekend plan is just avoiding people.	実際の週末の予定は人を避けることだけ。
acuity	sharpness	Coffee improves my mental acuity by at least 3%.	コーヒーは私の思考の鋭さを3％くらい上げてくれる。
adaptation	change	The movie is a weird adaptation of a cooking show.	その映画は料理番組の妙なアレンジだった。
add A to B	put A in B	Don’t forget to add sarcasm to your compliments.	褒め言葉には皮肉を忘れずに入れてね。
addict	fan	He's a phone addict who checks messages in dreams.	彼は夢の中でも通知を確認するスマホ中毒者だ。
addictive	habit-forming	This new cereal is dangerously addictive.	この新しいシリアル、中毒性がやばい。
address	speak to	She tried to address the issue, but the issue ran away.	彼女は問題に向き合おうとしたが、問題が逃げた。
adequate	enough	My cooking skills are adequate for survival… barely.	私の料理スキルは、かろうじて生存には足りてる。
adhesive	sticky	I used so much adhesive that now the table is part of the floor.	接着剤使いすぎて机が床の一部になった。
adjacent	next to	The cookie jar is always adjacent to danger.	クッキージャーはいつも危険の隣にある。
adjunct	add-on	He works as an adjunct professor and full-time snack critic.	彼は非常勤講師であり、常勤お菓子評論家でもある。
adjust	change slightly	I had to adjust my sleep schedule… again.	睡眠スケジュールをまた調整し直す羽目になった。
administer	give	She administered the quiz with the enthusiasm of a sloth.	彼女はナマケモノ並みのやる気で小テストを実施した。
admire	look up to	My cat admires no one. She *is* the queen.	うちの猫は誰も尊敬しない。彼女が女王なのだから。
admittedly	to be fair	Admittedly, I did eat the whole cake—but it was small.	確かにケーキ全部食べたけど、ちっちゃかったんだ。
admonish	warn	My mom admonished me with just one look.	母は一瞥で私を叱った。
adobe	clay	The house was made of adobe and good vibes.	その家は日干しレンガと良い雰囲気でできていた。
adolescent	teenager	Every adolescent thinks they invented sarcasm.	すべてのティーンは皮肉を発明したと思っている。
adopt	take in	We adopted a cat. She adopted our bed.	私たちは猫を引き取った。彼女は私たちのベッドを引き取った。
adorn	decorate	She adorned her laptop with 53 stickers and no regrets.	彼女はノートパソコンに53枚のステッカーを貼った。後悔はない。
advance	move forward	Technology advances faster than my ability to care.	技術の進歩は私の興味のスピードを超えている。
advancement	progress	His career advancement was powered by caffeine and chaos.	彼の出世はカフェインと混沌に支えられていた。
advantage	benefit	One advantage of being tall: top shelf snacks.	背が高いことの利点：上段のお菓子が取れる。
advent	arrival	The advent of winter means socks become permanent.	冬の到来＝靴下が一生モノになる。
adverse	bad	Adverse weather canceled my plans to do nothing outside.	悪天候のせいで、外で何もしない予定が中止に。
advertisement	ad	pandas in commercials = automatic win.	CMにパンダ出したら勝ち確。
advocate	supporter	He's an advocate for more snack breaks at work.	彼は職場のスナック休憩拡充を主張している。
aesthetic	style	Her aesthetic is 90% plants and 10% chaotic energy.	彼女の美学は植物9割、カオス1割。
affectionately	with love	He affectionately named his cactus "Spikezilla."	彼はサボテンに愛情を込めて「スパイクジラ」と名付けた。
affiliation	connection	My only gym affiliation is walking past it proudly.	私のジムとのつながりは、その前を誇らしく通り過ぎること。
affirmative	yes	The robot’s response was a firm “affirmative.”	ロボットの返答は力強い「了解」であった。
afflict	hurt	My weekend was afflicted by a wild swarm of deadlines.	週末は締切ラッシュに襲われた。
affluent	rich	Their dog lives a more affluent life than I do.	あの犬のほうが私より裕福に暮らしている。
afford	pay for	I can’t afford to lose my only pair of clean socks.	唯一の清潔な靴下を失う余裕はない。
after all	in the end	I didn’t need that third donut… after all.	結局、3つ目のドーナツはいらなかった。
aftermath	result	In the aftermath of karaoke night, my voice quit.	カラオケの翌日、私の声は辞職した。
against one's will	forced	I cleaned the room against my will and better judgment.	不本意かつ理性に反して部屋を片づけた。
agenda	plan	My weekend agenda: nap, snack, repeat.	週末の予定：昼寝→おやつ→繰り返し。
agent	representative	She hired an agent to negotiate her cat’s modeling career.	彼女は猫のモデル契約交渉のために代理人を雇った。
aggravate	make worse	My jokes aggravated the awkward silence.	私のジョークは気まずい沈黙をさらに悪化させた。
aggregate	total	The aggregate snack count exceeded human limits.	お菓子の総数が人間の限界を超えた。
aggressive	pushy	He plays chess with an aggressive potato chip strategy.	彼はポテチ片手に攻撃的なチェス戦法を使う。
agrarian	farming	The agrarian lifestyle looks peaceful—until 5AM rooster calls.	農業生活は平和そうに見えるが、朝5時のニワトリで台無し。
agree with ~	support ~	My stomach doesn’t agree with midnight tacos.	私の胃は深夜のタコスに賛成していない。
aid	help	Chocolate aided my recovery from the Monday blues.	チョコは月曜の憂鬱からの回復を助けてくれた。
aim	goal	My aim this weekend is to do absolutely nothing.	今週末の目標は「何もしないこと」。
aim at ~	target ~	The ad aims at people who think breakfast is optional.	その広告は朝ごはんを軽視してる人を狙っている。
airborne	in the air	My dreams are airborne, unlike my paper airplanes.	私の夢は空を飛ぶけど、紙飛行機は飛ばない。
aisle	walkway	I got lost in the snack aisle for 20 minutes.	お菓子売り場で20分迷子になった。
akin	similar	Coffee is akin to magic for morning zombies.	朝のゾンビにとってコーヒーは魔法に近い。
a large amount of ~	a lot of (uncountable)	I spilled a large amount of regret on my homework.	宿題に大量の後悔をこぼした。
a large number of ~	a lot of (countable)	A large number of socks vanish after laundry.	洗濯後、大量の靴下が消える。
alarmingly	worryingly	He is alarmingly good at making excuses.	彼は驚くほど言い訳がうまい。
alert	ready and careful	Stay alert during class—or risk becoming the example.	授業中は注意していよう。でないと例にされるぞ。
algae	tiny water plants	The pond was full of algae and mysterious bubbles.	池には藻と謎の泡がいっぱいだった。
alien	from another world	The movie alien looked friendly, but also slightly confused.	映画の宇宙人は友好的だったが、ちょっと混乱してるようにも見えた。
alienate	make someone feel left out	He alienated his teammates by always doing everything alone.	彼はいつも一人で全部やるので、仲間から浮いてしまった。
align	put in a straight line	Let’s align our goals—before our schedules explode.	スケジュールが崩壊する前に、目標をそろえよう。
all along	from the beginning	She knew all along, but waited for the dramatic reveal.	彼女は最初から知っていた。でも劇的な展開を待っていた。
all but ~	almost ~	The answer was all but correct—just one word ruined it.	その答えはほぼ正解だった。1語で台無しになったけど。
allergic	react badly to ~	He’s allergic to dust, noise, and group chats.	彼はほこりと騒音とグループチャットにアレルギーがある。
alleviate	make less painful	Stretching can alleviate stress—especially before presentations.	発表前にストレッチすると、ストレスが少し軽くなる。
alley	narrow street	They walked through a quiet alley that smelled like rain.	彼らは雨の匂いがする静かな路地を歩いた。
alliteration	repeating first sounds	The poem used alliteration like “silly shoes slide silently.”	その詩は「すべる靴が静かに滑る」みたいに頭韻を使っていた。
allocate	set aside or give	The teacher allocated 10 minutes for questions. We used 2.	先生は質問のために10分くれた。使ったのは2分だけ。
all of a sudden	suddenly	All of a sudden, the lights went out—and so did our focus.	突然、電気が消えた。集中力も一緒に。
allot	give or divide	The app allots time for breaks, which we all ignore.	そのアプリは休憩時間を割り当ててくれる。全員無視してるけど。
allowance	money given regularly	My allowance covers snacks, books, and questionable decisions.	お小遣いでまかなえるのはおやつと本と、微妙な選択肢。
allow for ~	plan for or consider	We need to allow for delays—especially on Mondays.	月曜は特に遅れを見込んでおくべきだ。
all the same	still / anyway	I didn’t need a reason, but I was grateful all the same.	理由は要らなかったけど、それでもありがたかった。
all the time	always	He hums all the time, even during serious moments.	彼はいつでも鼻歌を歌っている。真面目な時でも。
all the way	the whole distance	We walked all the way to the station—and realized it was closed.	駅までずっと歩いた。閉まってたけど。
allure	attraction or charm	The city has a strange allure—especially at night.	その街には不思議な魅力がある。特に夜になると。
allusion	indirect mention	Her joke had an allusion to a movie, but I missed it.	彼女の冗談には映画の話が含まれていたが、気づかなかった。
alongside	next to or with	He stood alongside his friends, trying to look confident.	彼は自信ありげに友達の隣に立った。
alter	change slightly	She altered her speech after realizing no one was listening.	誰も聞いていないと気づき、彼女は話し方を変えた。
alternate	take turns or switch	We alternate roles every week to stay sane.	正気を保つために、役割は毎週交代している。
alternative	another choice	As an alternative to studying, he cleaned the entire desk.	勉強の代わりに、彼は机を全部掃除した。
altimeter	height meter	The altimeter said we were high. My ears agreed.	高度計は高いと言っていた。耳もそう感じていた。
a man of ~	someone known for ~	He’s a man of few words—and many unread emails.	彼は口数は少ないが、未読メールは多い。
amass	collect a lot of	She managed to amass 100 pens. She uses 3.	彼女はペンを100本集めた。でも使ってるのは3本だけ。
amateur	not professional	The video looked like it was filmed by an amateur—and a brave one.	その映像は素人が撮ったように見えた。そして勇気ある素人だ。
a matter of course	something expected	It’s a matter of course that it rains when I forget my umbrella.	傘を忘れた日に限って雨が降るのは当然のことだ。
ambience	mood of a place	The room had nice ambience until someone played techno at full volume.	その部屋はいい雰囲気だった。大音量のテクノが流れるまでは。
ambiguous	unclear or not sure	Her answer was ambiguous, like a magic 8-ball.	彼女の答えはあいまいだった。まるで占いボールみたいに。
ambivalence	mixed feelings	I had ambivalence about joining—excited and terrified.	参加については複雑な気持ちだった。楽しみであり、怖くもあった。
ambulance	emergency car	The ambulance arrived fast. So did my regret.	救急車はすぐ来た。後悔もすぐ来た。
amenable	willing to do something	He was amenable to help—until he saw the spreadsheet.	彼は手伝う気満々だった。スプレッドシートを見るまでは。
amid	in the middle of ~	Amid the noise, she found a moment of peace.	騒音の中で、彼女は一瞬の静けさを見つけた。
amorphous	no clear shape	The idea was still amorphous, like fog with ambition.	そのアイデアは形が定まっていなかった。野心を持つ霧のようだった。
amount to ~	end up being ~	His excuses amounted to “I forgot.” Said in five paragraphs.	彼の言い訳は結局「忘れてた」。5段落かけて言ったけど。
ample	enough or more than enough	There was ample time to finish… and yet we panicked.	時間は十分にあった…のに、なぜかパニックになった。
anaesthetic	painkiller	They gave me an anaesthetic. I still felt the dentist’s judgment.	麻酔は効いたが、歯医者の冷たい視線は効かなかった。
analogous	similar in some way	Her study method is oddly analogous to cooking pasta.	彼女の勉強法はなぜかパスタを茹でるのに似ている。
analogy	comparison	Explaining English with ramen analogies is my superpower.	ラーメンの比喩で英語を説明するのが私の必殺技。
analysis	breakdown	My snack consumption analysis shows spikes on Mondays.	私のお菓子消費分析は月曜にピークがある。
anarchy	chaos	Without coffee, my morning turns into pure anarchy.	コーヒーがない朝は完全な無政府状態になる。
ancestor	past family	My ancestor probably didn’t snack this much.	先祖は多分こんなにお菓子食べてない。
anchor	heavy stopper	I need an emotional anchor when Wi-Fi is down.	Wi-Fiが落ちたとき、心のアンカーが必要になる。
and yet	still	It was raining cats and dogs, and yet… I forgot my umbrella.	土砂降りだったのに、それでも傘を忘れた。
~ and so forth	etc	I packed snacks, a blanket, ~ and so forth.	スナック、毛布、その他もろもろを詰めた。
anecdotal	story-based	Her advice was purely anecdotal, but oddly convincing.	彼女の助言は完全に体験談ベースだったが、妙に説得力があった。
annihilate	destroy	He annihilated the pizza like it insulted his family.	彼はピザをまるで家族の敵のように消し去った。
annotation	note	The textbook was unreadable without my chaotic annotations.	カオスな注釈がなければ教科書は読めなかった。
annual	yearly	Our annual tradition: pretending to exercise.	私たちの毎年の恒例行事は「運動するフリ」。
annum	year	The fee is $300 per annum, or 300 instant noodles.	年額300ドル、あるいはカップ麺300個分。
anomaly	odd thing	This quiet Monday is an anomaly I don’t trust.	静かな月曜日は信用ならない異常事態だ。
anonymous	nameless	An anonymous hero returned my lost sock.	匿名のヒーローが私の靴下を返してくれた。
answer for ~	take responsibility for	I refuse to answer for the vanishing cookies.	消えたクッキーの責任は取りません。
anthropology	human study	I studied anthropology to understand why we love memes.	人類学を学んだ理由は、なぜ人はミームを愛するのか知りたかったから。
antibiotic	germ killer	He asked if snacks count as antibiotics. They don’t.	彼はスナックがお薬になるか聞いたが、ならない。
anticipate	expect	I anticipated a boring meeting but got a free cookie.	退屈な会議を予想してたらクッキーが出てきた。
antidote	cure	The antidote to Monday is usually caffeine and denial.	月曜日への解毒剤は大体カフェインと現実逃避。
antipathy	strong dislike	He has deep antipathy toward pineapple on pizza.	彼はピザのパイナップルに強い嫌悪感を持っている。
antipode	opposite	My cat and I are emotional antipodes.	私と猫は感情的に真逆の存在。
antiquated	old-fashioned	My phone is so antiquated it still fears Wi-Fi.	私のスマホは古すぎてWi-Fiを恐れている。
antiquity	ancient times	I studied antiquity and still can’t use Excel.	古代を学んだけど、今でもExcelは使えない。
antiseptic	germ-free	The room smelled like antiseptic and mild regret.	その部屋は消毒液とほんのり後悔の香りがした。
anxiety	worry	My anxiety throws surprise parties at 2 AM.	私の不安は午前2時にサプライズパーティーを開く。
anything but ~	not at all	My desk is anything but organized.	私の机は整理整頓とはほど遠い。
a pair of ~	two of ~	I bought a pair of socks and lost one instantly.	靴下を1組買って、すぐに片方なくした。
apart from ~	except for	Apart from Mondays, life is tolerable.	月曜日以外は、人生まあまあマシ。
apathy	no interest	His apathy toward laundry is legendary.	彼の洗濯への無関心は伝説レベル。
apologize to A for B	say sorry to A about B	I apologized to my cat for stepping on her tail.	猫のしっぽを踏んで謝った。
apparatus	tool	The kitchen apparatus looks advanced but makes only toast.	その調理器具はすごそうだけど、パンしか焼けない。
apparent	clear	It’s apparent he didn’t study—he brought snacks, not notes.	彼が勉強してないのは明らかだ。ノートじゃなくてスナック持ってきた。
appeal to ~	attract to	Cute fonts always appeal to my weak will.	かわいいフォントはいつも私の意志の弱さを攻めてくる。
appease	calm down	To appease my anxiety, I gave it chocolate.	不安をなだめるためにチョコをあげた。
appendix	added section	The report's appendix includes a full list of snack data.	レポートの付録にはスナックの全データがある。
appetite	hunger	My appetite for fries is eternal.	フライドポテトへの食欲は永遠。
applicant	job seeker	Each applicant must bring a pen and low expectations.	応募者はペンと低めの期待を持参してください。
application	request form	My phone has 73 open applications, all ignored.	スマホに開きっぱなしのアプリが73個あるけど全部放置。
apply	use	I applied logic, then ignored it completely.	論理を適用したあと、完全に無視した。
apply A to B	put A on B	He applied whipped cream to toast like it was art.	彼はトーストにホイップを塗るのを芸術のようにやった。
apply for ~	request ~	I applied for a job and accidentally sent a cat meme.	仕事に応募したけど猫のミームを間違えて送った。
appointments	meetings	I missed two appointments and one nap.	予定を2つすっぽかして昼寝も逃した。
apportion	divide	She apportioned the cake unfairly—and took the biggest slice.	彼女はケーキを不公平に分けて一番大きいのを取った。
appraise	evaluate	He appraised my lunch like it was a fine painting.	彼は私の弁当を芸術品のように評価した。
appreciable	noticeable	There was no appreciable difference between “studying” and “staring.”	「勉強」と「ぼーっとする」の間に明確な違いは見られなかった。
appreciate	value	I appreciate you not judging my snack pile.	私のお菓子の山を批判しないでくれて感謝。
appreciation	gratitude	My cat shows appreciation by not biting me (today).	猫は今日は噛まなかったことで感謝を表した。
apprehensive	nervous	I’m apprehensive about cooking without burning something.	何かを焦がさずに料理することに不安がある。
apprentice	learner	As a baking apprentice, I specialize in edible disasters.	ベイキング見習いとして、食べられる災害を量産している。
approve of ~	agree with	My dog doesn’t approve of vegetables in his bowl.	うちの犬はごはんに野菜が入っているのを認めていない。
approximately	about	It takes approximately 7 snacks to feel alive again.	生き返るにはだいたい7個のお菓子が必要。
aptitude	talent	She has an aptitude for finding lost remotes.	彼女はリモコンを見つける才能がある。
aquaculture	fish farming	Aquaculture sounds fancy but involves a lot of wet socks.	水産養殖って聞こえはいいけど、びしょ濡れの靴下がつきもの。
aquatic	water-based	He dreams of owning an aquatic hamster race track.	彼の夢は水中ハムスター競技場を持つこと。
A rather than B	AじゃなくてB	I chose sleep rather than cleaning.	掃除ではなく睡眠を選んだ。
arbitrary	random	My playlist is so arbitrary it goes from Mozart to memes.	私のプレイリストはモーツァルトからミームまでランダム。
arbitrate	judge	He was asked to arbitrate the Great Pizza Topping Debate.	彼は壮絶なピザのトッピング論争の仲裁を頼まれた。
archaeology	study of ancient things	I studied archaeology and dug up 300 pens from my room.	考古学を学び、自分の部屋からペンを300本発掘した。
ardour	passion	He spoke of instant noodles with unusual ardour.	彼はカップ麺について異様な情熱を語った。
argue	disagree	My siblings argue about whose turn it is to do nothing.	兄弟たちは「今日は誰が何もしない番か」で口論する。
arise	happen	Problems arise when snacks disappear mysteriously.	お菓子が謎に消えると問題が発生する。
arithmetic	math	Basic arithmetic fails when snacks are involved.	お菓子が絡むと算数が崩壊する。
army	military	My snack army stands ready—mostly made of chocolate.	私のスナック軍は出撃準備完了。主にチョコでできている。
arouse	trigger	The smell of toast can arouse ancient breakfast cravings.	トーストの香りは古代の朝ごはん欲を呼び起こす。
arrange for ~	set up	I’ll arrange for snacks at the meeting. That’s the real agenda.	会議用にお菓子を用意しておきます。それが本当の議題。
arrangement	plan	The seating arrangement put me next to the snack table.	席の配置がスナックテーブルの隣だった。
array	collection	She owns an impressive array of mugs with cat faces.	彼女は猫の顔がついたマグカップを大量に持っている。
arrogance	too much pride	His arrogance was so big, it needed its own chair.	彼の偉そうな態度は椅子ひとつ分の大きさだった。
artefact	old thing made by people	The artefact looked ancient—and slightly like a coffee mug.	その遺物は古く見えたが、どことなくマグカップに似ていた。
arthritis	joint disease	She has arthritis, so her fingers complain every morning.	彼女は関節炎なので、朝になると指が文句を言う。
articulate	speak clearly	He can articulate his ideas better than most adults.	彼は多くの大人よりも自分の考えをはっきり言える。
artifice	trick	That shortcut was pure artifice—and took twice as long.	その近道は完全なごまかしだった。かえって時間がかかった。
artificial	not real	This flower is so artificial, it smells like plastic.	この花は人工的すぎて、プラスチックのにおいがする。
artisan	craft worker	The artisan made the bowl by hand, with love and a few mistakes.	その職人は愛情と少しのミスを込めて手作りの器を作った。
as a matter of fact	in fact	As a matter of fact, I did my homework—just not all of it.	実は宿題やったよ。全部じゃないけど。
as a result	so	He forgot his umbrella. As a result, his hair became modern art.	彼は傘を忘れた。その結果、髪型が現代アートになった。
as a rule	usually	As a rule, I don’t trust group chats after midnight.	基本的に、深夜のグループチャットは信用していない。
as a token of ~	as a sign of ~	He gave her a pencil as a token of peace.	彼は仲直りの印として鉛筆をあげた。
as a whole	overall	As a whole, the movie was great—except for the plot, acting, and ending.	全体としてその映画は良かった。ストーリーと演技と結末を除けば。
ascertain	find out	We tried to ascertain who left the door open. No one confessed.	誰がドアを開けっぱなしにしたのか確かめようとしたが、誰も白状しなかった。
ascribe	say the reason is ~	They ascribe his energy to coffee. It’s mostly chaos.	彼の元気の理由はコーヒーだと言われているが、実際は混沌だ。
ascribe A to B	think A happens because of B	She ascribed her success to hard work—not just lucky timing.	彼女は成功の理由を努力だと考えている。運の良さだけじゃなく。
as far as ~	about ~	As far as I know, cats don’t need alarm clocks.	私の知る限り、猫に目覚ましは不要だ。
as follows	like this	The rules are as follows: 1) Don’t panic. 2) Try. 3) Repeat.	ルールは次の通り：1）あわてない　2）やってみる　3）繰り返す。
as for~	about ~	As for that idea… let’s pretend we didn’t hear it.	そのアイデアについては…聞かなかったことにしよう。
as good as ~	almost ~	This game is as good as finished—unless someone presses “restart.”	このゲームはもう終わったも同然。誰かが「再開」を押さなければ。
a sheet of ~	one piece of ~	He gave me a sheet of paper with exactly one useful word.	彼は紙を一枚くれた。その中で使える言葉は1つだけだった。
ashore	onto land	They finally made it ashore, tired and full of new stories.	彼らはついに岸にたどり着いた。疲れていたが話のネタは満載だった。
as is often the case with ~	usually happens with ~	As is often the case with shortcuts, this one took longer.	近道にありがちなことだが、かえって時間がかかった。
as it were	so to speak	He was, as it were, the team’s “walking alarm clock.”	彼はいわばチームの「歩く目覚まし」だった。
ask a favour of ~	request help from ~	I’d like to ask a favour of you—but it doesn’t involve heavy lifting.	お願いがあるんだけど、重いものは運ばせないよ。
ask for ~	request	He asked for help but made it sound like a challenge.	彼は助けを求めたが、まるで挑戦状のようだった。
aspiring	hoping to be	She's an aspiring artist—her sketchbook is 90% dragons.	彼女は芸術家志望で、スケッチブックの9割がドラゴンの絵だ。
as regards ~	about	As regards the group project, no one remembers who started it.	グループ課題については、誰が始めたか誰も覚えていない。
assassinate	kill someone important	The movie hero tried to assassinate the villain—with a pie.	映画の主人公は敵を暗殺しようとした…パイで。
assault	attack	The report was so boring, it felt like a mental assault.	その報告書は退屈すぎて、頭を攻撃された気分になった。
assay	test or check	We assayed the idea by asking three people and a cat.	私たちはそのアイデアを3人と猫に聞いて試してみた。
assemble	bring together	We tried to assemble the shelf, but ended up with abstract art.	棚を組み立てようとしたが、できたのは抽象アートだった。
assent	agree	She gave a small nod of assent, mostly to end the meeting.	彼女は小さくうなずいた。同意というより会議を終わらせたくて。
assert	say strongly	He asserted he wasn’t wrong—just "creatively correct."	彼は自分が間違っていないと主張した。「創造的に正しい」だけだと。
assess	judge or check	We assessed the mess and called it "organized chaos."	私たちはその散らかりを見て「整理されたカオス」と判断した。
asset	useful thing	Her ability to stay calm during panic is a real asset.	パニック中に冷静でいられる能力は本当に貴重だ。
assiduous	hard-working	He’s so assiduous, even his to-do list has a to-do list.	彼はとても勤勉で、ToDoリストにもToDoリストがある。
assign	give a task	The teacher assigned us homework before we could escape.	先生は私たちが逃げる前に宿題を出した。
assimilate	become like others	She assimilated fast—by learning memes and inside jokes.	彼女はすぐになじんだ。ミームと内輪ネタで。
associate	connect or link	I always associate rainy days with long naps.	雨の日といえば長い昼寝を思い出す。
assonance	repeating vowel sounds	The poem’s assonance made it flow like a sleepy song.	その詩の母音の響きは、まるで眠たくなる歌のようだった。
as such	in that way	He’s not a leader as such, but people follow his ideas.	彼はいわゆるリーダーではないが、皆が彼の考えについていく。
assumed	supposed	I assumed the test was easy. It was not.	そのテストは簡単だと思っていた。違った。
assurance	confidence or promise	He gave his assurance, but forgot 10 seconds later.	彼は自信満々に約束したが、10秒後には忘れていた。
asteroid	small space rock	The asteroid flew by Earth while everyone was watching cat videos.	小惑星は地球のそばを通過した。みんなが猫動画を見ている間に。
as the saying goes	as people often say	As the saying goes, “Better late than confusing.”	ことわざにあるとおり、「遅れても意味不明よりマシ」だ。
asthma	trouble with breathing	He blamed his slow run on asthma—and tight shoes.	彼は走るのが遅いのを喘息ときつい靴のせいにした。
as to ~	about	As to the missing cookies, I have no comment.	クッキーがなくなった件については、ノーコメントです。
astonishing	very surprising	Her room was astonishingly clean. I thought I was in the wrong house.	彼女の部屋が驚くほどきれいで、家を間違えたかと思った。
astray	lost or off track	My thoughts went astray after slide 2 of the presentation.	プレゼンの2枚目で私の思考は迷子になった。
astronaut	space traveler	The astronaut said zero gravity is fun—until lunchtime.	宇宙飛行士は無重力は楽しいと言っていた。昼ご飯までは。
astronomer	space scientist	The astronomer looked serious—until he found a typo in the stars.	天文学者は真剣だった。星の中にスペルミスを見つけるまでは。
as usual	like always	As usual, he arrived late but with a good excuse.	いつも通り、彼は遅れてきたが言い訳は完璧だった。
~ as well	also	I brought my bag—and my bad mood as well.	カバンと一緒に、機嫌の悪さも持ってきた。
as yet	up to now	No one has, as yet, explained why the fire alarm smells like toast.	今のところ、火災報知器がトーストのにおいがする理由は誰も説明していない。
asylum	place of safety or care	He treated the library like an asylum from social interaction.	彼は図書館を人付き合いから逃れる避難所として扱っていた。
asymmetrical	not even	The drawing was asymmetrical, like it was nervous to be looked at.	その絵は非対称で、見られるのが苦手な感じだった。
at a glance	with a quick look	At a glance, the instructions looked easy. They were not.	一目見た限り、その説明は簡単そうだった。実際は違った。
at all times	always	The door must stay closed at all times—especially when it wants to open.	ドアは常に閉めておくこと。特に勝手に開きたがるときは。
at a loss	confused or unsure	I was at a loss when the printer asked me for “emotional support.”	プリンターに「心の支えが必要」と言われて困惑した。
at an end	finished	The semester was finally at an end. So was my energy.	学期がようやく終わった。私の体力も一緒に。
at any cost	no matter what	I must finish this game today, at any cost—even sleep.	このゲームは今日中にクリアする。睡眠を犠牲にしてでも。
at any moment	very soon	The teacher could call on me at any moment—so I looked busy.	先生がいつでも私を指名しそうだったので、忙しいフリをした。
at any rate	in any case	At any rate, the plan failed, but we learned… something.	とにかく、その計画は失敗したが、何かは学んだ。
at any time	whenever	You can join the meeting at any time, especially if you enjoy confusion.	いつでも会議に参加していいよ。混乱が好きなら特にね。
at a time	one by one	Please enter the room one at a time, unless you're synchronized.	1人ずつ入室してください。ただしシンクロしてるなら別。
at best	maybe, but not much	The result was a success at best, a disaster at worst.	結果はうまくいったとしてもせいぜい普通、悪く言えば惨事だった。
at ease	relaxed	He looked at ease—even though the fire drill just started.	彼はくつろいで見えた。避難訓練が始まったばかりなのに。
at face value	as it seems	Don’t take his “I’m fine” at face value—check the eye twitch.	彼の「大丈夫」はそのまま信じないで。まばたきの速さを見て。
at first	at the beginning	At first, the puzzle seemed easy. Then it laughed at me.	最初はパズルが簡単に見えた。でも途中からバカにされてる気がした。
at first hand	from personal experience	I learned at first hand that cats hate water. Lesson burned.	猫が水を嫌うことは身をもって知った。傷ももらった。
at first sight	immediately	At first sight, the room looked clean. Then I opened the closet.	一目見た限り部屋はきれいだった。クローゼットを開けるまでは。
at hand	nearby or soon	The test is at hand, and so is the feeling of regret.	テストが近い。そして後悔もすぐそこだ。
at heart	inside, really	He acts tough, but at heart he loves cartoons.	彼は強がってるけど、本当はアニメが大好きだ。
athlete	sport player	She trains like an athlete—even for board games.	彼女はボードゲームですらアスリートのようにトレーニングする。
at issue	being discussed	The real problem at issue is who ate the last donut.	今の議題は、誰が最後のドーナツを食べたかだ。
at large	not caught or free	The cat is still at large, probably planning its next move.	その猫はいまだ逃走中。たぶん次の一手を考えている。
at last	finally	At last, the internet came back. Cheers were heard everywhere.	ついにインターネットが復活した。あちこちから歓声が上がった。
at least	not less than	I didn’t win, but at least I remembered my name.	勝てなかったが、名前を忘れなかっただけマシだ。
at leisure	in a relaxed way	He read the manual at leisure—after breaking everything.	彼はゆっくり説明書を読んだ。すべて壊した後に。
at length	for a long time	She talked at length about frogs. I stopped understanding halfway.	彼女はカエルについて長々と語った。途中から理解不能だった。
atmosphere	the feeling in a place	The café had a nice atmosphere, until the karaoke started.	そのカフェはいい雰囲気だった。カラオケが始まるまでは。
atomise	break into small pieces	The plan atomised the moment three people had opinions.	3人が意見を言い出した瞬間、その計画は粉々になった。
at once	right away	He stood up at once when he heard “cake.”	「ケーキ」と聞いた瞬間、彼は即座に立ち上がった。
at one's best	in top condition	She’s at her best when she’s not being watched.	彼女は見られていないときが一番力を発揮する。
at one's convenience	when it’s good for you	Please reply at your convenience—next year is fine too.	ご都合のいい時に返信ください。来年でも大丈夫です。
at one's wits' end	very confused or stressed	I was at my wits’ end when the printer said “offline” again.	プリンターがまた「オフライン」と言った時、私は限界だった。
at short notice	with little warning	The class was moved at short notice, and my brain didn’t get the memo.	授業は急に変更されたが、私の脳には伝わっていなかった。
at present	now	At present, I’m calm. But the group chat hasn’t replied yet.	今は落ち着いてる。でもグループチャットはまだ既読無視。
at random	without order	He chose the answer at random and still got it right. Lucky guess.	彼は適当に答えを選んだが正解した。運だけで。
atrophy	weaken over time	My ability to talk to people atrophied after one long weekend.	たった一回の長い週末で、会話力が衰えた。
attach	connect or add	Don’t forget to attach the file this time. Seriously.	今度こそファイルの添付を忘れないで。マジで。
attain	reach or get	He attained level 100 in the game, but forgot to eat lunch.	彼はゲームでレベル100に到達したが、昼ご飯を忘れていた。
attempt	try	I attempted to stay focused. Then came the cat.	集中しようとした。でも猫が来た。
attest	prove or confirm	I can attest that this chair is dangerous—ask my back.	この椅子が危険なのは証明できる。私の背中が語っている。
at the age of ~	when ~ years old	At the age of 9, he started coding. At 10, he broke the Wi-Fi.	9歳で彼はコーディングを始め、10歳でWi-Fiを壊した。
at the back of ~	behind ~	There’s a weird smell coming from the back of the fridge.	冷蔵庫の奥から、なんか変な匂いがしてる。
at the cost of ~	with loss of ~	She got full marks—at the cost of two all-nighters.	彼女は満点を取った。その代償は徹夜2回。
at the mercy of ~	controlled by ~	We were at the mercy of the autocorrect. It betrayed us all.	オートコレクトに支配されていた。全員裏切られた。
at the minute	at the moment	I’m not hungry at the minute. That could change in 5 minutes.	今はお腹すいてないけど、5分後はわからない。
at the risk of ~	maybe causing ~	At the risk of sounding lazy—I think this chair is too far.	怠け者っぽく聞こえるかもしれないけど、この椅子遠すぎる。
at the same time	together	He laughed and sneezed at the same time. Impressive.	彼は笑いながらくしゃみをした。同時に。すごい。
at the sight of ~	when seeing ~	At the sight of the pop quiz, the whole class froze.	抜き打ちテストを見た瞬間、クラス全体が固まった。
at the top of one's voice	very loudly	She sang at the top of her voice. The windows filed a complaint.	彼女は全力で歌った。窓が苦情を言いそうな勢いだった。
at this rate	if it continues like this	At this rate, we’ll be ready by 2050. Maybe.	このペースだと準備が整うのは2050年。たぶん。
attitude	the way you think or feel	His attitude toward Mondays is basically self-defense.	彼の月曜日への態度は、ほぼ自己防衛。
attribute A to B	say A is because of B	She attributes her success to effort—and good headphones.	彼女は成功の理由を努力と良いヘッドホンだと言っている。
awaken	wake up or notice	He finally awakened to the truth: his plant was plastic.	彼はようやく気づいた。自分の植物がプラスチックだったことに。
award	prize or gift	She got an award for being helpful—and always having pens.	彼女は親切さと、いつもペンを持っていることが評価されて表彰された。
awareness	knowing something	His awareness of deadlines is strong—right after they pass.	彼の締切への意識は高い。過ぎたあとに。
a week from today	7 days later	A week from today, I’ll be better—or still procrastinating.	1週間後には成長している…か、まだ先延ばししてるかだ。
awkward	embarrassing or weird	There was an awkward silence after I said “You too” to “Happy Birthday.”	「誕生日おめでとう」に「君もね」と返して、気まずい沈黙が流れた。
awry	not right or messed up	Our plan went awry when someone brought glitter.	誰かがラメを持ち込んだ時点で、計画は狂った。
axis	center line	The Earth spins on its axis—and so does my attention.	地球は軸で回っている。私の集中力も同じくらい不安定だ。
bait	something to attract	The discount was bait—and I walked right into the store.	割引はエサだった。そして私はまんまと店に入った。
balance	evenness or control	I tried to keep my balance—and my dignity—on the ice.	氷の上でバランスと尊厳を同時に保とうとした。
balk	refuse to do something	He balked at cleaning his room. The mess didn’t.	彼は部屋の掃除を拒否した。散らかりはそうしなかった。
ban	forbid or stop	The school banned phones. Students discovered... books.	学校が携帯を禁止した。生徒たちは本を発見した。
bandage	cover for wounds	I used a bandage—not for the cut, but for emotional support.	絆創膏を貼った。傷のためじゃなく、心の支えとして。
bankrupt	out of money	He went emotionally bankrupt after one group presentation.	グループ発表一回で彼は感情的に破産した。
bankruptcy	failure with money	After buying 5 smoothies, I declared personal bankruptcy.	スムージー5本買ったあと、私は個人破産を宣言した。
barbed	having sharp points	The comment was barbed—polite words, sharp meaning.	そのコメントはトゲがあった。丁寧な言葉で鋭く刺すタイプ。
barely	almost not	I barely passed the test—thanks to question 10.	そのテストはギリギリ合格した。第10問のおかげで。
barren	empty or unable to grow	The field was so barren, even the weeds looked bored.	その土地はあまりに何もなくて、雑草さえ退屈そうだった。
barrister	lawyer (in court)	The barrister argued with style, logic, and dramatic finger-pointing.	その法廷弁護士は、論理と派手な指さしで戦った。
barter	trade without money	They bartered a sandwich for a pencil. Surprisingly fair.	彼らはサンドイッチと鉛筆を物々交換した。意外と平等だった。
